######
#.  .#
#$   #
# $  #
#@   #
######