########
#.    .#
# $   $#
#@     #
########