       #####
     ###   ###
     #       #
     # $   $ #
    ## #$ $# ##
 ####    $    ####
 #      # #      #
## $#  .....  #$ ##
#   $ #.#.#.# $   #
#    $ ..@.. $    #
#   $ #.#.#.# $   #
## $#  .....  #$ ##
 #      # #      #
 ####    $    ####
    ## #$ $# ##
     # $   $ #
     #       #
     ###   ###
       #####