######
#    #
#    #
#   .#
# $#.##
##@$. #
 #$   #
 #  ###
 ####