
########
#   #  #
# $ #  #
# # #@ #
# $$## #
# #   .#
# $ # .#
#   $ .#
#####..#
    ####