  ####     ####
  #  #######  #
###           ###
#   .#  #  #.   #
#  ..# $#$ #..  #
## ###  #  ### ##
 #     $#$     #
 #  $   #   $  #
 # ########### #
 #  $   #   $  #
 #     $#$     #
## ###  #  ### ##
#  ..# $#$ #..  #
#   .#  #  #.   #
###     @     ###
  #  #######  #
  ####     ####