######
#  #.##
# $$$.#
#  $  #
#@ #..#
#######